1010
BBBBBBBBBB
BPPPPPPPPB
BPBBBBBBPB
BPBBBBBBPB
BPBBBBBBPB
BPBBBBBBPB
BPBBBBBBPB
BPBBBBBBPB
BPBBBBBBPB
BSBBBBBBGB