1010
BBBBBBBBBB
BBBBBBBBBB
BBBBBBBBBB
BBBBPPPPBB
BBBBPBBPBB
SPPPPBBPBB
BBBPBBBPBB
BBBPBBBPBB
BBBPPPPPPG
BBBBBBBBBB