1010
0000000000
0000000000
0000000000
0000PPPP00
0000P00P00
SPPPP00P00
000P000P00
000P000P00
000PPPPPPG
0000000000